
NO ./textures/diamond.xpm

SO ./textures/mchassig.xpm

EA ./textures/wood.xpm

WE ./textures/stone.xpm

F 255.0.0

C 0.0.0

1111111
100N001
1000001
1111111
