
NO ./textures/diamond.xpm

SO ./textures/mchassig.xpm

EA ./textures/wood.xpm

WE ./textures/stone.xpm

F 255.0.0

C 0.0.0

111111111111111111111111111111111111111111111111111111111
111111111111111111111111111111111111111111111111111111111
111111111111111111111111111111111111111111111111111111111
111111111111111111111111111111111111111111111111111111111
111111111111111111111111111111111111111111111111111111111
100000000000000000000000000000000000000000000000000000001
100000000000000000000000000000000000000000000000000000001
100000000000000000000000000000000000000000000000000000001
100000000000000N00000000000000000000000000000000000000001
101111100000000000000000000000000000000000000000000000001
100000000000000001100001100000000000000000000000000000001
100000001000000001100001100000000000000000000000000000001
100000000000000000000000000000000000000000000000000000001
100000000000000000000000000000000000000000000000000000001
100000000000000000000000000000000000000000000000000000001
100000000000000000000000000000000000000000000000000000001
100000000000000000000000000000000000000000000000000000001
100000000000000000000000000000000000000000000000000000001
100000000000000000000000000000000000000000000000000000001
100000000000000000000000000000000000000000000000000000001
100000000000000000000000000000000000000000000000000000001
100000000000000000000000000000000000000000000000000000001
100000000000000000000000000000000000000000000000000000001
100000000000000000000000000000000000000000000000000000001
100000000000000000000000000000000000000000000000000000001
100000000000000000000000000000000000000000000000000000001
100000000000000000000000000000000000000000000000000000001
100000000000000000000000000000000000000000000000000000001
100000000000000000000000000000000000000000000000000000001
100000000000000000000000000000000000000000000000000000001
100000000000000000000000000011111111111111111111111111111
100000000000000000000000000011111111111111111111111111111
100000000000000000000000000011111111111111111111111111111
100000000000000000000000000011111111111111111111111111111
100000000000000000000000000011111111111111111111111111111
111111111111111111111111111111111111111111111111111111111
111111111111111111111111111111111111111111111111111111111
