
NO ./textures/diamond.xpm
SO ./textures/mchassig.xpm
WE ./textures/stone_minecraft.xpm
EA ./textures/wood.xpm

F 220,100,0
C 225,30,0


11111111111111
10000000000001
1011100111000111111111
1000111000010000000001
10110000N0010011111001
1000111000010010000101
1010000010000000000001
1111111111111111111111
