
NO ./random_path

SO ./second_random_path

EA ./third_random_path

WE ./fourth_random_path

F 123.123.123

C 123.123.1123

11111111
10000001
10000001
1000N001
11111111
