

NO ./textures/mchassig.xpm

SO ./textures/mchassig.xpm

EA ./textures/mchassig.xpm

WE ./textures/mchassig.xpm

F 123,123,123

C 123,123,255



111111111111111111111111111111111111111111111111111111111
111111111111111111111111111111111111111111111111111111111
111111111111111111111111111111111111111111111111111111111
111111111111111111111111111111111111111111111111111111111
111111111111111111111111111111111111111111111111111111111
100000000000000000000000000000000000100000100000000000001
100000000000000011111111111111010010001000110000000000001
10000000000000000000000000000001001111011S100000000000001
100000000000000000000000000000010010000010010100000000001
100000000000000000000000000000000000000001000100000000001
100000000000000000000000000000000000000000111000000000001
100000000000000000000000000000000000000000000000000000001
100000000000000000000000000000000000000000000000000000001
100000000000000000000000000000000000000000000000000000001
100000000000000000000000000000000000000000000000000000001
100000000000000000000000000000000000000000000000000000001
100000000000000000000000000000000000000000000000000000001
100000000000000000000000000000000000000000000000000000001
100000000000000000000000000000000000000000000000000000001
100000000000000000000000000000000000000000000000000000001
100000000000000000000000000000000000000000000000000000001
100000000000000000000000000000000000000000000000000000001
100000000000000000000000000000000000000000000000000000001
100000000000000000000000000011111111111111111111111111111
100000000000000000000000000011111111111111111111111111111
100000000000000000000000000011111111111111111111111111111
100000000000000000000000000011111111111111111111111111111
100000000000000000000000000011111111111111111111111111111
111111111111111111111111111111111111111111111111111111111
111111111111111111111111111111111111111111111111111111111
