NO ./textures/diamond.xpm

SO ./textures/mchassig.xpm

EA ./textures/wood.xpm

WE ./textures/stone.xpm

F 123,123,255

C 123,123,112

11111111111111
10000010000001
1000001000S001
11110000000001
10000000000001
11111111111111
