
NO ./textures/diamond.xpm

SO ./textures/mchassig.xpm

EA ./textures/wood.xpm

WE ./textures/stone.xpm

F 123.123.123

C 123.123.1123

11111111111111
10000010000001
10000010000001
11110000N00001
10000000000001
11111111111111
